1111Hello1111
100100000C0C1
1000011111001
1P001100E0001
1111111111111
