1111111111111
1C00E000P0001
1111111111111
