1111111111111
1000000001001
1000P00001001
1000000001CE1
1111111111111
