11111111111
100CPE00001
10000000001
