1111111111111
1001000W000C1
1C00001111001
10001100W0001

1P001100E0001
1000000W00001
1111111111111
