1111111111111
100100000E0C1
1000011111001
1C00110000001
1111111111111
