1111111111111
100100000E0C1
100001111101
1P00110000
1111111111111
